8
7
########
#o...D #
# .g#1# 
##d###d#
#~ ~M34#
#~p~M P#
####MMMM